NO textures/north.xpm
SO textures/south.xpm
WE textures/west.xpm
EA textures/east.xpm

F      173,    99,     64                                      
                             
                         
C 22, 12, 200

                         

1111111111111111111111111
1N1011000010000000000001
1100110000000000111111001
 1000110000000000110001001
1000000000100000000001001
11111111111111111111111111

        

                              










