NO Untitled.xpm
SO Untitled1.xpm
WE Untitled2.xpm
EA Untitled3.xpm

F 18,53,25
C 153,204,255

111111111111
111111111111
111111110001
100000000011
10S000000001
111111111111
111111111111
111111111111
