   WE                              Untitled.xpm   
NO      Untitled3.xpm   
   

SO Untitled2.xpm

F      173,    38,     64                                      

EA Untitled1.xpm                                   
                         
C 22, 12, 21

                         


        

111111
100001
1N0011
111111
                                     










