   WE                              west.xpm   
NO      north.xpm   
   

SO south.xpm

F      173,    99,     64                                      

EA east.xpm                                  
                         
C 22, 12,    200

                         


        11111
1111111111101
111111110000011111111111111111
10S0110000100000000000001
1000110000100000111111001
10001100000000001100010011
1000000000100000000001001
1111111111111111111111111
                                     










