   WE                            Untitled.xpm
NO      Untitled3.xpm



SO Untitled2.xpm

F      17,    38,     64

EA Untitled1.xpm



C 218, 234, 235

 1111111111111111111111111
 10S0110000100000000000001
1000110000000000111111001
 1000110000000001100010011111
 1000000000100000000001001
 1111111111111111111111111
