   WE                            Untitled.xpm
NO      Untitled3.xpm



SO Untitled2.xpm

F      17,    3,     64

EA Untitled1.xpm

                                            

C 28, 234, 235

 1111111111111111111111111
 10011000010000000000011
1000110000N00000111111001
 1000110000000001100010011111
 1000000000100000000001001
 1111111111111111111111111
