NO Untitled.xpm
SO Untitled1.xpm
WE Untitled2.xpm
EA Untitled3.xpm

F 50,50,50
C 135,206,235

1111111111111
1000000000001
1000111000001
1000010000001
1000N10000001
1000000000001
1111111111111
